111111
1000E1
111011
10PC01
100011
110001
111111
