1111111111111111111
1000E00010000C00001
1110000C11000000011
10PC00000C000C00001
10000000010C0000011
110C000011000C00001
100000100C000001111
10000C10C00000010C1
110C00100C000000001
1111111111111111111
