1111111111111111111
1000E00010000000001
1110C00011000000011
10P0000000000000001
1000000001000000011
1100000011000000001
1000001000000001111
1000001000000001001
1100001000000000001
1111111111111111111
