1111111111111111111
1000000010000000C01
1110C00011000000011
10P0000000000E00001
10000000010000C0011
110C000011000000001
1000001000000001111
1000001000000001001
11C0001000C00000001
1111111111111111111
