1111111111111111111
1000000010000000C01
1110C00011000000011
10P0000000000E00001
10000C00010000C0011
110CC00011000000001
10000010000C0001111
10000010000C0001001
11C0001000C00000001
1111111111111111111
